and=и
bool=булева_стойност
break=прекъсни
case=за_случая
cerr=екран_грешки
char=символ
cin=клавиатура
class=клас
cout=екран
const=константи
continue=продължи_следващо
define=дефинирам
double=реално_число_двойна_точност
else=иначе
enum=изброим
false=невярно
float=реално_число
for=за
friend=приятел
goto=иди_на
if=ако
inline=на_място
int=цяло_число
long=цяло_число_голямо
namespace=пространство
new=нов
not=не
operator=оператор
or=или
private=лични
protected=защитени
public=общодостъпни
register=в_регистър
return=върни
short=цяло_число_кратко
signed=със_знак
sizeof=размер_на
static=статична
string=низ
struct=структура
switch=в_случай_че
template=шаблон
this=този
true=вярно
union=обединение
unsigned=без_знак
using=използва
virtual=виртуален
void=липсва
while=щом
xor=изключващо_или