and=и,връща вярно когато и двете условия са верни
array=масив,указва масив - поредица от еднотипни променливи, наречени елементи, достъпни чрез общо име и индекс
Assign=Свържи,свързва дадена файлова променлива със физически файл на диска
begin=начало,начало на блок от оператори
boolean=булева_стойност,логически (булев) тип данни, съдържащ стойност True (Вярно) или False (Невярно)
break=прекъсни_цикъла,прекъсва изпълнението на цикъл; изпълнението на продължава от следващия оператор след цикъла
byte=цяло_число_байт,цяло число без знак и стойност в диапазона 0..255
case=в_случай_че,указва израз, в зависимост от стойността на който ще се изпълни един от няколко оператора
class=клас,указва начало на декларация на клас
Close=Затвори,затваря отворен файл и обновява съдържанието му
comp=цяло_число_голямо_специално,цяло число в диапазона -2^-63+1 .. 2^63 -1 и точност 20 знака
const=константи,следват декларации на константи
continue=продължи_следващо,прекъсва текущото изпълнение на командите от тялото на цикъла; прави се проверка дали не е достигнат края на цикъла, и ако не е, изпълнението продължава със следващо завъртане от цикъла
div=деление,целочислено деление
do=изпълни,указва командите, които ще се изпълняват за всяко завъртане на цикъла
double=реално_число_двойна_точност,реално число в диапазона 5 * 10^-308 .. 1.7 * 10^308 и точност 16 знака
downto=надолу_до,указва крайната стойност, до която ще намалява стойността на променливата
else=иначе,указва оператора, който ще се изпълни ако условието връща стойност False (Невярно)
end=край,край на блок от оператори, на оператор case или на декларация на запис или клас,
EOF=Край_Файл,връща стойност Вярно (True) ако е достигнат края на файла
extended=реално_число_голяма_точност,реално число в диапазона 3.4 * 10^-4932 .. 11 * 10^4932 и точност 20 знака
file=файл,указва дисков файл от определен тип еднотипни елементи
FilePos=Файл_Позиция,връща моментното положение на файловия указател
FileSize=Файл_Размер,връща броя елементи, които са записани във файла
for=за,указва променлива, стойността на която ще се променя с единица за всяко завъртане на цикъла между дадена начална и крайна стойност
function=функция,начало на функция
goto=иди_на,указва етикет, от който нататък ще продължи изпълнението
Halt=Спри,спира изпълнението на програмата 
if=ако,указва условие, в зависимост от което се изпълнява един или друг оператор
implementation=реализация,указва частта от модула, която е недостъпна от други модули и е за реализация на обявеното в интерфейса
integer=цяло_число,цяло число със знак и стойност в диапазона -32768..32767
interface=интерфейс,указва публичната част от модула, която описва интерфейса, чрез който другите модули могат да ползват текущия
label=етикети,следват декларации на етикети
longint=цяло_число_голямо,цяло число със знак и стойност в диапазона -2147483648..2147483647
mod=остатък,остатък от целочислено деление
nil=нищо,стойност за указател, който не сочи към нищо
not=не,връща стойност вярно, ако операнда, към който е приложена има стойност невярно
of=е,ако е след case: указва начало на възможните стойности, и операторите които ще се изпълнят за тях; ако е след array или file: указва типа на елементите, от които ще се състои масива или файла
or=или,връща стойност вярно, ако поне един от операндите има стойност вярно
private=лични,елементи на класа, които са достъпни само в методите от класа и от модула, в който е дефиниран клас
procedure=процедура,начало на процедура
protected=защитени,елементи на класа, достъпни само от методите на класа и неговите наследници
program=програма,начало на програмата
property=свойство,вид данни за класа,прочитането на които може да стане и с функция
public=общодостъпни,елементи на класа, които са достъпни за всички
Read=Прочети,прочита стойност на променлива от клавиатурата или от файл
ReadLn=Прочети_До_Нов_Ред,прочита стойност на променлива от клавиатурата или от файл и игнорира всичко друго до края на реда
real=реално_число,реално число в диапазона 2.9 * 10^-39 .. 1.7 * 10^38 и точност 12 знака
record=запис,указва запис - поредица от разнотипни променливи, наречени полета, достъпни чрез своето име
repeat=повтаряй,указва начало на група команди, които ще се повтарят, докато не се изпълни дадено условие
Reset=Нулирай,отваря файл за четене или презапис
return=върни,указва резултата който ще върне функцията
ReWrite=Презапиши,отваря файл за презапис
Seek=Търси,пренасочва файловия указател към указан елемент във файла
shortint=цяло_число_кратко,цяло число със знак и стойност в диапазона -128..127
single=реално_число_единична_точност,реално число в диапазона 1.5 * 10^-45 .. 3.49 * 10^38 и точност 8 знака
string=низ,поредица от символи
then=то,указва оператора, който ще се изпълни ако условието връща стойност True (Вярно)
to=до,указва крайната стойност, до която ще нараства стойността на променливата
type=типове,следват декларации на типове данни
unit=модул,съдържа декларации, които може да бъдат използвани в други модули
until=докато,указва условие, което щом се изпълни, ще спре повтарянето на групата команди преди until. Условието се проверява след всяко завъртане на цикъла (след изпълнението на командите, включени в тялото на цикъла)
uses=използва,използвани са външни модули
var=променливи,следват декларации на променливи
while=щом,указва условие, което докато е изпълнено, ще се повтарят дадена група команди. Условието се проверява преди всяко завъртане на цикъла (т.е. преди изпълнението на командите, включени в тялото на цикъла)
word=цяло_число_дума,цяло число без знак и стойност в диапазона 0..65535
Write=Напиши,отпечатва изрази или ги записва във файл
WriteLn=Напиши_И_Нов_Ред,отпечатва изрази или ги записва във файл и добавя нов ред накрая
xor=изключващо_или,връща стойност вярно само ако двата операнда са с различен знак
