and=и
array=масив
assign=свържи
begin=начало
boolean=булеваСтойност
break=прекъсни
byte=цялоЧислоБайт
case=когато
class=клас
close=затвори
comp=цялоЧислоГолямоСпециално
const=константи
continue=продължи
div=деление
do=изпълни
double=реалноЧислоДвойнаТочност
downto=надолуДо
else=иначе
end=край
eof=крайФайл
extended=реалноЧислоГолямаТочност
file=файл
filepos=файлПозиция
filesize=файлРазмер
finally=накрая
for=за
function=функция
goto=иди
halt=спри
if=ако
implementation=реализация
in=в
integer=цялоЧисло
interface=интерфейс
label=етикети
longint=цялоЧислоГолямо
mod=остатък
nil=нищо
not=не
of=е
or=или
private=лични
procedure=процедура
program=програма
property=свойство
protected=защитени
public=общодостъпни
read=прочети
readln=прочетиРед
real=реалноЧисло
record=запис
repeat=повтаряй
reset=нулирай
return=върни
rewrite=презапиши
seek=търси
shortint=цялоЧислоКратко
single=реалноЧислоЕдиничнаТочност
string=низ
then=тогава
to=до
try=опитай
type=типове
unit=модул
until=докато
uses=използва
var=променливи
while=щом
word=цялоЧислоДума
write=напиши
writeln=напишиРед
xor=изключващоИли
