and=връща вярно когато и двете условия са верни
array=указва масив - поредица от еднотипни променливи, наречени елементи, достъпни чрез общо име и индекс
Assign=свързва дадена файлова променлива със физически файл на диска
begin=начало на блок от оператори
boolean=логически (булев) тип данни, съдържащ стойност True (Вярно) или False (Невярно)
break=прекъсва изпълнението на цикъл; изпълнението на продължава от следващия оператор след цикъла
byte=цяло число без знак и стойност в диапазона 0..255
case=указва израз, в зависимост от стойността на който ще се изпълни един от няколко оператора
class=указва начало на декларация на клас
Close=затваря отворен файл и обновява съдържанието му
comp=цяло число в диапазона -2^-63+1 .. 2^63 -1 и точност 20 знака
const=следват декларации на константи
continue=прекъсва текущото изпълнение на командите от тялото на цикъла; прави се проверка дали не е достигнат края на цикъла, и ако не е, изпълнението продължава със следващо завъртане от цикъла
div=целочислено деление
do=указва командите, които ще се изпълняват за всяко завъртане на цикъла
double=реално число в диапазона 5 * 10^-308 .. 1.7 * 10^308 и точност 16 знака
downto=указва крайната стойност, до която ще намалява стойността на променливата
else=указва оператора, който ще се изпълни ако условието връща стойност False (Невярно)
end=край на блок от оператори, на оператор case или на декларация на запис или клас,
EOF=връща стойност Вярно (True) ако е достигнат края на файла
extended=реално число в диапазона 3.4 * 10^-4932 .. 11 * 10^4932 и точност 20 знака
file=указва дисков файл от определен тип еднотипни елементи
FilePos=връща моментното положение на файловия указател
FileSize=връща броя елементи, които са записани във файла
for=указва променлива, стойността на която ще се променя с единица за всяко завъртане на цикъла между дадена начална и крайна стойност
function=начало на функция
goto=указва етикет, от който нататък ще продължи изпълнението
Halt=спира изпълнението на програмата 
if=указва условие, в зависимост от което се изпълнява един или друг оператор
implementation=указва частта от модула, която е недостъпна от други модули и е за реализация на обявеното в интерфейса
integer=цяло число със знак и стойност в диапазона -32768..32767
interface=указва публичната част от модула, която описва интерфейса, чрез който другите модули могат да ползват текущия
label=следват декларации на етикети
longint=цяло число със знак и стойност в диапазона -2147483648..2147483647
mod=остатък от целочислено деление
nil=стойност за указател, който не сочи към нищо
not=връща стойност вярно, ако операнда, към който е приложена има стойност невярно
of=ако е след case: указва начало на възможните стойности, и операторите които ще се изпълнят за тях; ако е след array или file: указва типа на елементите, от които ще се състои масива или файла
or=връща стойност вярно, ако поне един от операндите има стойност вярно
private=елементи на класа, които са достъпни само в методите от класа и от модула, в който е дефиниран клас
procedure=начало на процедура
protected=елементи на класа, достъпни само от методите на класа и неговите наследници
program=начало на програмата
property=вид данни за класа,прочитането на които може да стане и с функция
public=елементи на класа, които са достъпни за всички
Read=прочита стойност на променлива от клавиатурата или от файл
ReadLn=прочита стойност на променлива от клавиатурата или от файл и игнорира всичко друго до края на реда
real=реално число в диапазона 2.9 * 10^-39 .. 1.7 * 10^38 и точност 12 знака
record=указва запис - поредица от разнотипни променливи, наречени полета, достъпни чрез своето име
repeat=указва начало на група команди, които ще се повтарят, докато не се изпълни дадено условие
Reset=отваря файл за четене или презапис
return=указва резултата който ще върне функцията
ReWrite=отваря файл за презапис
Seek=пренасочва файловия указател към указан елемент във файла
shortint=цяло число със знак и стойност в диапазона -128..127
single=реално число в диапазона 1.5 * 10^-45 .. 3.49 * 10^38 и точност 8 знака
string=поредица от символи
then=указва оператора, който ще се изпълни ако условието връща стойност True (Вярно)
to=указва крайната стойност, до която ще нараства стойността на променливата
type=следват декларации на типове данни
unit=съдържа декларации, които може да бъдат използвани в други модули
until=указва условие, което щом се изпълни, ще спре повтарянето на групата команди преди until. Условието се проверява след всяко завъртане на цикъла (след изпълнението на командите, включени в тялото на цикъла)
uses=използвани са външни модули
var=следват декларации на променливи
while=указва условие, което докато е изпълнено, ще се повтарят дадена група команди. Условието се проверява преди всяко завъртане на цикъла (т.е. преди изпълнението на командите, включени в тялото на цикъла)
word=цяло число без знак и стойност в диапазона 0..65535
Write=отпечатва изрази или ги записва във файл
WriteLn=отпечатва изрази или ги записва във файл и добавя нов ред накрая
xor=връща стойност вярно само ако двата операнда са с различен знак
