and=и
array=масив
Assign=Свържи
begin=начало
boolean=булева_стойност
break=прекъсни_цикъла
byte=цяло_число_байт
case=в_случай_че
class=клас
Close=Затвори
comp=цяло_число_голямо_специално
const=константи
continue=продължи_следващо
div=деление
do=изпълни
double=реално_число_двойна_точност
downto=надолу_до
else=иначе
end=край
EOF=Край_Файл
extended=реално_число_голяма_точност
file=файл
FilePos=Файл_Позиция
FileSize=Файл_Размер
for=за
function=функция
goto=иди_на
Halt=Спри
if=ако
implementation=реализация
integer=цяло_число
interface=интерфейс
label=етикети
longint=цяло_число_голямо
mod=остатък
nil=нищо
not=не
of=е
or=или
private=лични
procedure=процедура
protected=защитени
program=програма
property=свойство
public=общодостъпни
Read=Прочети
ReadLn=Прочети_До_Нов_Ред
real=реално_число
record=запис
repeat=повтаряй
Reset=Нулирай
return=върни
ReWrite=Презапиши
Seek=Търси
shortint=цяло_число_кратко
single=реално_число_единична_точност
string=низ
then=то
to=до
type=типове
unit=модул
until=докато
uses=използва
var=променливи
while=щом
word=цяло_число_дума
Write=Напиши
WriteLn=Напиши_И_Нов_Ред
xor=изключващо_или
